AD: Andorra
AE: United Arab Emirates
AF: Afghanistan
AG: Antigua and Barbuda
AI: Anguilla
AL: Albania
AM: Armenia
AO: Angola
AR: Argentina
AT: Austria
AU: Australia
AW: Aruba
AX: Åland Islands
AZ: Azerbaijan
BB: Barbados
BD: Bangladesh
BF: Burkina Faso
BG: Bulgaria
BH: Bahrain
BJ: Benin
BL: Saint Barthélemy
BM: Bermuda
BN: Brunei Darussalam
BO: Bolivia, Plurinational State of
BR: Brazil
BS: Bahamas
BT: Bhutan
BW: Botswana
BY: Belarus
BZ: Belize
CA: Canada
CD: Congo, the Democratic Republic of the
CF: Central African Republic
CG: Republic of the Congo
CI: Côte d'Ivoire
CK: Cook Islands
CL: Chile
CM: Cameroon
CN: China (People's Republic of China)
CO: Colombia
CR: Costa Rica
CU: Cuba
CV: Cape Verde
CW: Curaçao
CZ: Czech Republic
DE: Germany
DJ: Djibouti
DM: Dominica
DO: Dominican Republic
DZ: Algeria
EC: Ecuador
EE: Estonia
EG: Egypt
EH: Western Sahara
ER: Eritrea
ET: Ethiopia
FJ: Fiji
FK: Falkland Islands (Malvinas)
FM: Micronesia, Federated States of
FR: France
GA: Gabon
GB: United Kingdom
GD: Grenada
GE: Georgia
GG: Guernsey
GH: Ghana
GI: Gibraltar
GL: Greenland
GM: Gambia
GN: Guinea
GQ: Equatorial Guinea
GT: Guatemala
GU: Guam
GW: Guinea-Bissau
GY: Guyana
HN: Honduras
HR: Croatia
HT: Haiti
HU: Hungary
ID: Indonesia
IE: Ireland
IL: Israel
IM: Isle of Man
IN: India
IQ: Iraq
IR: Iran, Islamic Republic of
IT: Italy
JE: Jersey
JM: Jamaica
JO: Jordan
JP: Japan
KE: Kenya
KG: Kyrgyzstan
KH: Cambodia
KI: Kiribati
KM: Comoros
KN: Saint Kitts and Nevis
KP: Korea, Democratic People's Republic of
KR: Korea, Republic of
KW: Kuwait
KY: Cayman Islands
KZ: Kazakhstan
LA: Laos (Lao People's Democratic Republic)
LB: Lebanon
LC: Saint Lucia
LI: Liechtenstein
LR: Liberia
LS: Lesotho
LT: Lithuania
LU: Luxembourg
